NO ./path_to_the_north_texture
SO ./path_to_the_south_texture
R 15212    50000
WE       ./path_to_the_west_texture
   EA ./path_to_the_east_texture

S   ./sprite.xpm
F 128,128,128

 C 1,11,128  

1111111
1000001
1222221
122N221
1222221
1222221
1111111